20,u
,,,,,,,,,,u,,,,
,,,,,,,,,,,,,,,
,,,,,,,,u,,,,,u
,,,,,,,,,u,,,,,
,u,u,,,,,,,,,,,
,,,u,,,,u,,,u,,
u,,u,,,,u,,,,,,
,,,,,,,,,,,,,,,
,,,,,,,,,,,,,,,
,,,,,,,,,,,,,u,
,,,,,,,,,,u,,,u
,,,,,,,,,,u,,,,
,,,u,,,,,,,u,,u
,,u,,,,,,,,,,,,
,,,,,,,u,,,,,,,
,,,,,,,u,,,,,,,
,,,,,,,u,,u,,,,
,,,,,u,,,,,,,,,
,,,,,,,,,,,,,,,
,,,,,,,,,u,,,,,
